1 1 1 1 1 1 1 1 1 1 1 1 1 1 1
1 2 2 2 2 0 0 0 0 0 0 0 0 2 1
1 0 r 0 r 0 r 2 r 0 r 2 r 2 1
1 0 2 2 2 2 r 2 2 0 0 2 0 0 1
1 0 r 0 r 0 r 0 r 0 r 2 r 0 1
1 2 0 q 0 0 r 0 0 d 0 2 0 0 1
1 2 r 0 r 0 r 2 r 0 r 2 r 0 1
1 2 0 2 2 2 r 2 2 0 0 0 0 0 8
1 0 r 2 r 0 r r r r r r r r 1
1 0 0 2 0 0 0 0 0 0 0 0 0 0 1
1 0 r 0 r 0 r r r r r r r 2 1
1 0 0 d 0 0 r 0 0 2 0 d 0 2 1
1 0 r 0 r 0 r 0 r 2 r 2 r 0 1
1 0 0 0 0 0 r 0 0 0 0 2 2 0 1
1 1 1 1 1 1 1 8 1 1 1 1 1 1 1
