1 1 1 1 1 1 1 8 1 1 1 1 1 1 1
1 2 0 0 0 0 0 0 0 0 2 2 2 0 1
1 2 r r 2 r r r r r 2 r r 0 1
1 0 0 2 d 0 0 0 0 0 0 0 2 2 1
1 0 0 2 2 2 2 2 0 0 0 0 0 2 1
1 0 r r r r r 0 r r r r r 2 1
1 2 2 2 0 0 0 0 2 2 0 0 0 2 1
1 r r 0 r r r r r r r 2 r r 1 
1 0 0 2 2 2 0 0 0 0 d 2 2 0 1
1 0 r r r r r 0 r r r r r 0 1
1 2 0 0 d 2 0 0 0 2 2 2 0 0 1
1 2 2 2 0 0 0 0 0 2 0 0 0 0 1
1 0 r r r r r 2 r r r r r 2 1
1 0 0 0 0 0 0 0 0 0 0 0 0 2 1
1 1 1 1 1 1 1 8 1 1 1 1 1 1 1
